██████████
█        █
█ ████ ███
█ █      █
█ █ ██ ███
█ █ █    █
█ █ █ ████
█ █ █    █
█P█     E█
██████████