██████████
█P█      █
█ █ █████ █
█ █ █   █ █
█ █ █ █ █ █
█   █ █   █
█████ █████
█         █
█       E █
██████████